020a0c060a0c020a0c060a0a0c060c04
060a0d050405060a0b0b0a0805050505
0504050505070d060e0a0a0a09050505
0505050505050309030c060a0a09030d
0505070b0905020a0c05070a0a0a0c05
0309070a0c070a0a0905030a0a0c0501
060a09060905060a0a09060a0c050504
030a0c050609030a0c060b0c03090505
0c0c0505070a0c060905020904060905
050505030b0c05050405060a09030a09
070d030a0a090505070f09020a0a0a0c
05070a0e0a0a0b0905030c060a0a0e09
05030a0b0c060a0a0b0c0505020a0b08
030a0a0c0505060c06090505060c060c
060a0a0903090505070c030905050505
030a0a0b0a0a090309030a0a09030901
01ba
02fd